





                                      PMMMMMMMMMMMMMMMMMMMO
                                      BXXXXXXXXXXXXXXXXXXXV
                                     MOXXXXXXXXXXXXXXXXXXXP
                                     SDXXXXXXXXXXXXXXXXXXXD
                                     NUXXXXXXXXXXXXXXXXXXXI
                                      BXXXXXXXXXXXXXXXXXXXV
                                      BXXXXXXXXXXXXXXXXXXXV
                                      BXXXXXXXXXXXXXXXXXXXV
                                      OXXXXXXXXXXXXXXXXXXXP
                                      DXXXXXXXXXXXXXXXXXXXD
                                      UXXXXXXXXXXXXXXXXXXXI
                                      BXXXXXXXXXXXXXXXXXXXV
                                      BXXXXXXXXXXXXXXXXXXXV
                                      BXXXXXXXXXXXXXXXXXXXV
                                      OXXXXXXXXXXXXXXXXXXXP
                                      DXXXXXXXXXXXXXXXXXXXD
                                      UXXXXXXXXXXXXXXXXXXXI
                                      BXXXXXXXXXXXXXXXXXXXV
                                      BXXXXXXXXXXXXXXXXXXXV
                                      BXXXXXXXXXXXXXXXXXXXV
                                      OXXXXXXXXXXXXXXXXXXXP
                                      DXXXXXXXXXXXXXXXXXXXD
                                      UXXXXXXXXXXXXXXXXXXXI