        PMMMMMMMMMMMMMMMMMMMMMMMMMMMO            PMMMMMMMMMMMMMMMMMMMMMMMMO
        BXXXXXXXXXXXXXXXXXXXXXXXXXXXV            BXXXXXXXXXXXXXXXXXXXXXXXXV
        BXXXXXXXXXXXXXXXXXXXXXXXXXXXV            BXXXXXXXXXXXXXXXXXXXXXXXXV
        BXXXXXXXXXXXXXXXXXXXXXXXXXXXV            BXXXXXXXXXXXXXXXXXXXXXXXXV
        BXXXXXXXXXXXXXXXXXXXXXXXXXXXPMMMMMMMMMMMMOXXXXXXXXXXXXXXXXXXXXXXXXV
        BXXXXXXXXXXXXXXXXXXXXXXXXXXXDXXXXXXXXXXXXDXXXXXXXXXXXXXXXXXXXXXXXXV
        BXXXXXXXXXXXXXXXXXXXXXXXXXXXINNNNNNNNNNNNUXXXXXXXXXXXXXXXXXXXXXXXXV
        BXXXXXXXXXXXXXXXXXXXXXXXXXXXV            BXXXXXXXXXXXXXXXXXXXXXXXXV
        BXXXXXXXXXXXXXXXXXXXXXXXXXXXV            BXXXXXXXXXXXXXXXXXXXXXXXXV
        BXXXXXXXXXXXXXXXXXXXXXXXXXXXV            BXXXXXXXXXXXXXXXXXXXXXXXXV  
        INPDONNNNNNNNNNNNNNNNPDONNNNU            INNNNNNNNNNNNNNXXXXXXXXXXV
          BXV                BXV                                BXXXXXXXXXV
          BXV                BXV                                BXXXXXXXXXV
          BXV                BXV                                BXXXXXXXXXV
          BXV           PMMMMIDUMMMMO                           BXXXXXXXXXV
          BXV           BXXXXXXXXXXXV                           BXXXXXXXXXV
 PMMMMMMMMIDUMMMO       BXXXXXXXXXXXV                           BXXXXXXXXXV
 BXXXXXXXXXXXXXXV       BXXXXXXXXXXXV                           BXXXXXXXXXV
 BXXXXXXXXXXXXXXV       BXXXXXXXXXXXV                           BXXXXXXXXXV
 BXXXXXXXXXXXXXXV       INNNNNNNNNNNU                           BXXXXXXXXXV
 BXXXXXXXXXXXXXXV                                               BXXXXXXXXXV
MOXXXXXXXXXXXXXXV                                               BXXXXXXXXXV
SDXXXXXXXXXXXXXXV                                               BXXXXXXXXXV
NUXXXXXXXXXXXXXXV                                               BXXXXXXXXXV
 BXXXXXXXXXXXXXXV                                               BXXXXXXXXXV
 INNNNNNNNNNNNNNU                                               INNNPZONNNU