        PMMMMMMMMMMMMMMMMMMMMMMMMMMMO            PMMMMMMMMMMMMMMMMMMMMMMMMO
        BXXXXXXXXXXXXXXXXXXXXXXXXXXXV            BXXXXXXXXXXXXXXXXXXXXXXXXV
        BXXXXXXXXXXXXXXXXXXXXXXXXXXXV            BXXXXXXXXXXXXXXXXXXXXXXXXV
        BXXXXXXXXXXXXXXXXXXXXXXXXXXXV            BXXXXXXXXXXXXXXXXXXXXXXXXV
        BXXXXXXXXXXXXXXXXXXXXXXXXXXXPMMMMMMMMMMMMOXXXXXXXXXXXXXXXXXXXXXXXXV
        BXXXXXXXXXXXXXXXXXXXXXXXXXXXDXXXXXXXXXXXXDXXXXXXXXXXXXXXXXXXXXXXXXV
        BXXXXXXXXXXXXXXXXXXXXXXXXXXXINNNNNNNNNNNNUXXXXXXXXXXXXXXXXXXXXXXXXV
        BXXXXXXXXXXXXXXXXXXXXXXXXXXXV            BXXXXXXXXXXXXXXXXXXXXXXXXV
        BXXXXXXXXXXXXXXXXXXXXXXXXXXXV            BXXXXXXXXXXXXXXXXXXXXXXXXV
        BXXXXXXXXXXXXXXXXXXXXXXXXXXXV            BXXXXXXXXXXXXXXXXXXXXXXXXV  
        INPDONNNNNNNNNNNNNNNNPDONNNNU            INNNNNNNNNNNNNNOXXXXXXXXXV
          BXV                BXV                                BXXXXXXXXXV
          BXV                BXV                                BXXXXXXXXXV
          BXV                BXV                                BXXXXXXXXXV
          BXV           PMMMMIDUMMMMO                           BXXXXXXXXXV
          BXV           BXXXXXXXXXXXV                           BXXXXXXXXXV
 PMMMMMMMMIDUMMMM       BXXXXXXXXXXXV                           BXXXXXXXXXV
 BXXXXXXXXXXXXXXV       BXXXXXXXXXXXV                           BXXXXXXXXXV
 BXXXXXXXXXXXXXXV       BXXXXXXXXXXXV                           BXXXXXXXXXV
 BXXXXXXXXXXXXXXV       INNNNNNNNNNNU                           BXXXXXXXXXV
 BXXXXXXXXXXXXXXV                                               BXXXXXXXXXV
MPXXXXXXXXXXXXXXV                                               BXXXXXXXXXV
SDXXXXXXXXXXXXXXV                                               BXXXXXXXXXV
NIXXXXXXXXXXXXXXV                                               BXXXXXXXXXV
 BXXXXXXXXXXXXXXV                                               BXXXXXXXXXV
 INNNNNNNNNNNNNNU                                               INNNPZONNNU